GGGggGGGGTSTGGgGGSTGGTGGTGgGGTGGgSTGGGgGSGGGGGG
GSSGTSGGTGGTGGgGTSSSTSSSgGGSSTgGgSGGGGGGGgggGGG
GTGGSSTgTggGTGGSGGGGGSTGGGGGGTGGTGSTgggGGGGGGGG
STGGSTGGGggTSTSGGGSgGGTSgSGGTGgSGSggGTGGSSTgTgg
gSTgSGGTGTGGGSTSGGSSGGGgGgTgGgTSTGGGGGGGggggGGG
SGGGTGgGGGGSTGTGTgGgGGGGSGGTGgSGGSgGgGGGGGGGGGG
GGGgGGGGgTSGgGGSgGGGgGGGGTgTGSGGGggSGGGGGGGTGGG
TGGSgSGTSTGgGGTGGTSGGGgSTGGTGGgggGGGGgTGGSSTgTg
GTGggGGTSGGSSTGGTSGgGTGGgSGgGGSTSTGGGgGGTGGTGGG
GSTGGSGGTSgGGgTSTGGGgGSGGSTGGgTSgGGSggGGGgggGGG
GGTGgGTGGGGGGGTGGGGTGGGgGSGGTGGGGGSGGGSGGGGTGGG
SGGTSgSTGgSGgGGTSTGGGgGGGgGTGgGGTGTTGgGGGGggGGG
GSTGGGGSGGSGGTSTGGSgGGGSTSGSGGGSgGGGGGGGGGGGGGG
SGGgGGTSgGGTGGGgGTGGTGSGTGGGGSTSGSTTSGTGGSSTgTg
SGgGTGGGSGSTGGGgSSGTGTGTGGTSSTGgggGGGGGGGGGTGGG
GGgGGGgGGGGgGTGgGGTGGgGTTSGgGGGGTGGgGGGGGGGGGGG
gSSSTgSgSSTGSGGGGGTgGGSTGgggggGGGGGGGSgSSSGgGGG
TGgSGGGTGGTGSTGSGGGTGTGGGGTGgGGGGGGGggGGGGGGGGG
GTGGGGGGGgGTGGGgSGGGTGGTGGTGGSSTgTGGGGGgggGGGgg
GTGgGGTgGGGTGGSGGGTGSTGGTGGGTSGGGGTGgggGGGGTGGG
SGGGTGGGTGTGGTGGGGGGTGGTSGGGGGGGGGGGGGGGGGGGGGG
SGGTGGGTGGTGTGGTGTGGTGGGgGGTGGgGGgGGGgGGgGGTgGG
GGGgGGGgGGGGgGGTGgGTGGGGGggGGGGGGGGgggGGGGGGGGG
GTGgGGTGGGGTGGTGTGGGgGGGGGGGGGGGGGGGGGGGgggTGGG
SGGGTSTSGGGTGGGTGGGGSGGGTGTGGgGGGTGGSSTgTGGGGgg
GgGGGGGGGTGTGGTGGGGGTGGGTGgGGTGGGGGGggGGGGGTGGG
GGGSGGGGSGSGGGTSTTGGGTGgGGGGGGTGGSSTgTGGGgggGGG
SGGTGGGgGTGGGTGGGGSGGGGTGTGGGTGGGTGggGGGGGGTGGG
SGGGTGGTGGTGGGTGGGGTGGGTGTGgGGTGGGTGGSSTgTGGggg
SGGTGGGTGGTGTGGTGTGGTGGGgGGTTGGSSTgTGGggGGGGGTG
GGGgGGGgGGGGgGGTGgGTGGGGGTGGSSTgTGGGGGGGGGgggGG
GTGgGGTGGGGTGGTGTGGGgGGGGGGGGTGGSSTgTgggGGGGGGT
SGGGTSTSGGGTGGGTGGGGSGGGTGTGGgGGGGGGGGGgggGGGGG
GgGGGGGGGTGTGGTGGGGGTGGGTGgTGGSSTgTGGggGGGGGTGG
GGGSGGGGSGSGGGTSTTGGGTGgGGGGGGTGGSSTgTGGGGGgggG
SGGTGGGgGTGGGTGGGGSGGGGTGTGGGTGGGTGggSSSGGGGGGG
SGGGTGGTGGTGGGTGGGGTGGGTGTGgGGTGGGTggGGGgGGTGgG
gGGGSGGGGTGGGGGGTGTGGTGGgGGTGggGGGGGGSSTGGSSTgT
SGGTGGGgGTGGGTGGGGSGGGGTGTGGGTGGGTGggGGGGGGTGGG
SGGGTGGTGGTGGGTGGGGTGGGTGTGgGGTGGGTggGGGGgggGGG
gGGGSGGGGTGGGGGGTGTGGTGGgGGTGggGGGGGGGGGGggTGGG
